1|1|1|1|1|1|1|1|1|1
1|1|1|1|1|1|1|1|1|1
1|1|2|4|4|4|4|2|1|1
1|1|2|4|4|4|4|2|1|1
1|1|1|1|1|1|1|5|1|1
1|1|2|3|3|3|3|2|1|1
1|1|2|3|3|3|3|2|1|1
1|1|1|1|1|1|1|1|1|1
1|1|1|1|1|1|1|1|1|1
1|1|1|1|1|1|1|1|1|1